28 23
352 32
832 672
5
2 480 224
2 418 320
3 512 672
1 32 576
3 832 672
4
256 256
192 128
32 320
352 32
3 3 3 3 3 3 3 3 3 3 3 3 3 3 3 3 3 3 3 3 3 3 3 3 3 3 3 3
3 1 1 1 1 1 1 1 1 1 3 1 1 1 1 1 3 1 1 1 1 1 1 1 1 1 1 3
3 1 1 1 1 1 1 1 1 1 3 1 1 1 1 1 3 1 1 1 1 1 1 1 1 1 1 3
3 1 1 3 3 3 3 3 1 1 3 1 1 3 1 1 3 1 1 3 1 1 3 3 3 1 1 3
3 1 1 3 1 1 1 3 1 1 3 1 1 3 1 1 3 1 1 3 1 1 1 1 3 1 1 3
3 1 1 3 1 3 3 3 1 1 3 3 3 3 1 1 3 1 1 3 3 3 1 1 3 1 1 3
3 1 1 3 1 1 1 3 1 1 1 1 1 3 1 1 1 1 1 3 1 1 1 1 3 1 1 3
3 1 1 3 3 3 1 3 3 3 3 1 1 3 1 1 1 3 3 3 1 1 3 3 3 3 3 3
3 1 1 1 1 3 1 3 1 1 1 1 1 3 1 1 1 1 1 3 1 1 1 1 1 1 1 3
3 3 3 1 1 3 1 3 3 3 3 3 3 3 3 3 3 3 3 3 1 1 1 1 1 3 3 3
3 1 3 1 1 1 1 3 1 1 1 1 1 1 1 1 1 1 1 1 1 1 1 1 1 1 1 3
3 1 3 3 3 1 1 3 3 3 3 3 3 3 1 1 3 3 3 3 3 3 3 3 3 1 1 3
3 1 1 1 3 1 1 1 1 1 3 1 1 1 1 1 3 1 1 1 1 1 1 1 3 1 1 3
3 1 3 1 3 3 3 3 1 1 3 1 1 3 3 3 3 1 1 3 3 3 1 1 3 1 1 3
3 1 3 1 1 1 1 3 1 1 3 1 1 1 1 1 3 1 1 1 1 3 1 1 3 1 1 3
3 3 3 1 3 1 1 3 1 1 3 3 3 3 1 1 3 1 1 3 3 3 1 1 3 1 1 3
3 1 1 1 3 1 1 3 1 1 1 1 1 3 1 1 1 1 1 3 1 1 1 1 3 1 1 3
3 1 3 3 3 1 1 3 3 3 3 1 1 3 1 1 3 3 3 3 1 1 3 3 3 1 1 3
3 1 3 1 1 1 1 3 1 1 1 1 1 3 1 1 1 1 1 3 1 1 1 1 3 1 1 3
3 1 3 3 3 3 3 3 1 1 3 3 3 3 3 3 3 3 3 3 3 3 1 1 3 1 1 3
3 1 1 1 1 1 1 1 1 1 1 1 1 1 1 1 1 1 1 1 1 1 1 1 3 1 1 3
3 1 1 1 1 1 1 1 1 1 1 1 1 1 1 1 1 1 1 1 1 1 1 1 3 1 9 3
3 3 3 3 3 3 3 3 3 3 3 3 3 3 3 3 3 3 3 3 3 3 3 3 3 3 3 3