26 38
32 1152
32 64
9
2 224 992
2 608 736
1 736 1120
3 128 704
2 96 224
3 672 160
2 96 544
2 736 480
1 216 448
9
192 928
640 672
32 672
736 1152
180 64
736 64
32 544
736 544
228 416
3 3 3 3 3 3 3 3 3 3 3 3 3 3 3 3 3 3 3 3 3 3 3 3 3 3
3 3 3 3 3 3 3 3 3 3 3 3 3 3 3 3 3 3 3 3 3 3 3 3 3 3
3 9 7 7 7 0 0 0 0 0 1 4 7 7 7 7 0 0 7 7 7 7 1 0 3 3
3 0 7 7 7 2 0 0 0 0 1 0 7 7 7 7 1 1 0 7 4 1 1 0 3 3
3 0 7 7 1 1 1 1 1 0 1 0 0 0 0 5 1 1 0 0 2 0 0 0 3 3
3 0 0 0 0 4 1 0 1 1 1 1 0 0 0 1 1 1 1 1 1 1 0 0 3 3
3 0 0 0 0 1 1 0 0 0 4 1 1 0 0 1 0 0 0 0 0 1 1 7 3 3
3 0 1 1 1 1 1 5 0 0 0 0 1 5 0 1 0 0 0 0 0 1 1 7 3 3
3 0 1 1 1 1 1 5 7 7 7 7 1 5 0 1 0 0 1 1 0 1 4 7 3 3
3 0 0 0 1 5 5 5 7 7 7 7 1 5 0 1 0 0 0 0 0 0 4 0 3 3
3 0 0 0 1 1 1 1 0 0 0 0 1 5 0 1 1 1 1 0 0 0 0 0 3 3
3 0 0 0 0 0 4 1 2 0 0 0 1 1 1 1 0 0 1 1 1 0 0 0 3 3
3 0 1 1 1 1 1 1 1 1 1 1 1 1 5 5 0 0 0 0 1 2 0 0 3 3
3 0 5 5 5 5 5 0 0 0 0 1 1 1 5 5 1 1 1 0 1 1 1 0 3 3
3 0 7 7 7 0 0 0 0 0 0 1 4 1 1 5 1 1 1 0 1 0 0 0 3 3
3 0 7 1 7 0 0 0 1 1 1 1 0 0 1 1 2 0 0 0 1 0 0 0 3 3
3 0 1 1 1 0 0 0 1 1 0 0 0 0 0 1 1 1 1 1 1 0 0 0 3 3
3 0 0 0 0 0 0 0 0 0 0 0 0 0 0 0 0 0 0 0 0 0 0 0 3 3
3 3 3 3 3 3 3 3 3 3 3 3 3 3 3 3 3 3 3 3 3 3 3 0 3 3
3 3 3 3 3 3 3 3 3 3 3 3 3 3 3 3 3 3 3 3 3 3 3 0 3 3
3 3 3 3 3 3 3 3 3 3 3 3 3 3 3 3 3 3 3 3 3 3 3 0 3 3
3 1 1 1 1 1 1 1 1 1 1 1 1 1 4 1 1 1 1 0 0 5 0 0 3 3
3 5 5 5 0 0 1 0 0 0 0 1 1 1 5 5 5 1 1 0 5 5 5 0 3 3
3 5 5 5 5 0 4 0 0 0 0 0 0 0 5 6 6 5 0 0 0 6 1 0 3 3
3 0 1 1 0 6 6 6 7 0 0 0 0 0 5 5 5 5 0 0 0 4 1 0 3 3
3 0 1 1 0 0 6 6 7 0 0 1 1 1 1 1 1 1 0 0 0 1 1 0 3 3 
3 0 1 1 1 0 0 0 7 5 5 1 1 1 1 6 6 1 1 0 0 1 1 0 3 3
3 0 1 1 1 0 0 0 7 5 5 1 1 1 1 6 6 1 1 0 0 1 1 0 3 3
3 1 1 1 1 4 5 5 5 5 5 5 5 5 5 6 6 1 1 0 0 1 1 0 3 3
3 0 0 0 5 1 1 1 1 1 1 1 6 1 1 4 6 1 1 0 6 6 1 0 3 3
3 0 0 0 5 1 1 1 6 6 6 1 1 0 1 1 1 1 1 1 6 6 1 0 3 3
3 0 0 0 5 5 1 1 1 1 6 1 1 0 0 1 0 0 0 0 0 0 1 0 3 3
3 0 0 0 5 5 5 1 1 1 0 0 5 5 5 5 0 0 0 0 0 0 1 0 3 3
3 1 1 1 1 0 0 1 1 1 0 5 1 1 4 5 5 5 1 1 1 1 1 0 3 3
3 1 1 1 4 0 0 1 1 1 0 1 1 1 1 1 1 1 1 1 1 1 1 0 3 3
3 1 1 6 6 0 0 0 0 0 0 1 1 1 1 1 1 1 6 6 6 1 1 0 3 3
3 1 1 1 1 1 1 1 1 1 1 1 1 1 1 5 5 5 5 5 5 5 5 0 3 3
3 3 3 3 3 3 3 3 3 3 3 3 3 3 3 3 3 3 3 3 3 3 3 3 3 3