28 23
32 64
832 672
0
1
192 64
3 3 3 3 3 3 3 3 3 3 3 3 3 3 3 3 3 3 3 3 3 3 3 3 3 3 3 3
3 1 1 1 1 1 1 1 1 1 3 1 1 1 1 1 3 1 1 1 1 1 1 1 1 1 1 3
3 1 1 1 1 1 1 1 1 1 3 1 1 1 1 1 3 1 1 1 1 1 1 1 1 1 1 3
3 1 1 3 3 3 3 3 1 1 3 1 1 3 1 1 3 1 1 3 1 1 3 3 3 1 1 3
3 1 1 3 1 1 1 3 1 1 3 1 1 3 1 1 3 1 1 3 1 1 1 1 3 1 1 3
3 1 1 3 1 3 3 3 1 1 3 3 3 3 1 1 3 1 1 3 3 3 1 1 3 1 1 3
3 1 1 3 1 1 1 3 1 1 1 1 1 3 1 1 1 1 1 3 1 1 1 1 3 1 1 3
3 1 1 3 3 3 1 3 3 3 3 1 1 3 1 1 1 3 3 3 1 1 3 3 3 3 3 3
3 1 1 1 1 3 1 3 1 1 1 1 1 3 1 1 1 1 1 3 1 1 1 1 1 1 1 3
3 3 3 1 1 3 1 3 3 3 3 3 3 3 3 3 3 3 3 3 1 1 1 1 1 3 3 3
3 1 3 1 1 1 1 3 1 1 1 1 1 1 1 1 1 1 1 1 1 1 1 1 1 1 1 3
3 1 3 3 3 1 1 3 3 3 3 3 3 3 1 1 3 3 3 3 3 3 3 3 3 1 1 3
3 1 1 1 3 1 1 1 1 1 3 1 1 1 1 1 3 1 1 1 1 1 1 1 3 1 1 3
3 1 3 1 3 3 3 3 1 1 3 1 1 3 3 3 3 1 1 3 3 3 1 1 3 1 1 3
3 1 3 1 1 1 1 3 1 1 3 1 1 1 1 1 3 1 1 1 1 3 1 1 3 1 1 3
3 3 3 1 3 1 1 3 1 1 3 3 3 3 1 1 3 1 1 3 3 3 1 1 3 1 1 3
3 1 1 1 3 1 1 3 1 1 1 1 1 3 1 1 1 1 1 3 1 1 1 1 3 1 1 3
3 1 3 3 3 1 1 3 3 3 3 1 1 3 1 1 3 3 3 3 1 1 3 3 3 1 1 3
3 1 3 1 1 1 1 3 1 1 1 1 1 3 1 1 1 1 1 3 1 1 1 1 3 1 1 3
3 1 3 3 3 3 3 3 1 1 3 3 3 3 3 3 3 3 3 3 3 3 1 1 3 1 1 3
3 1 1 1 1 1 1 1 1 1 1 1 1 1 1 1 1 1 1 1 1 1 1 1 3 1 1 3
3 1 1 1 1 1 1 1 1 1 1 1 1 1 1 1 1 1 1 1 1 1 1 1 3 1 9 3
3 3 3 3 3 3 3 3 3 3 3 3 3 3 3 3 3 3 3 3 3 3 3 3 3 3 3 3