25 19
32 64
4
1 224 160
1 608 352
1 32 512
2 736 480
4
256 160
672 352
32 544
736 544
3 3 3 3 3 3 3 3 3 3 3 3 3 3 3 3 3 3 3 3 3 3 3 3 3
3 3 3 3 3 3 3 3 3 3 3 3 3 3 3 3 3 3 3 3 3 3 3 3 3
3 0 0 0 0 0 1 1 1 1 1 2 5 5 5 0 1 1 1 1 1 1 1 0 3
3 0 0 0 0 0 1 4 0 0 1 0 0 0 5 0 1 0 5 5 5 5 5 0 3 
3 0 1 1 1 1 1 0 0 0 1 0 0 0 0 0 1 4 5 5 0 5 5 0 3
3 0 5 5 0 0 0 0 0 0 1 0 0 5 5 0 1 1 1 1 0 0 0 0 3 
3 0 5 5 5 1 1 1 1 1 1 0 0 5 5 0 0 0 0 1 4 0 0 0 3 
3 0 5 0 0 1 0 0 0 5 5 5 5 5 5 0 4 1 1 1 1 1 1 1 3 
3 1 1 1 1 1 0 0 0 0 0 5 5 5 0 0 1 1 0 0 0 5 5 0 3 
3 1 1 1 1 1 1 1 1 1 1 1 1 1 0 0 1 0 0 0 0 5 5 0 3 
3 0 0 0 1 0 4 0 0 0 0 0 4 1 1 1 1 0 0 0 5 5 4 0 3 
3 0 5 5 1 0 0 0 5 5 5 0 0 0 0 0 1 0 0 0 0 0 4 0 3 
3 0 5 5 1 0 0 5 5 5 5 5 5 5 0 0 1 0 0 0 4 4 4 0 3 
3 0 5 5 1 0 0 0 0 5 5 5 5 5 5 0 1 1 1 1 1 1 1 1 3 
3 0 5 5 1 1 1 1 1 4 0 0 5 0 0 0 1 4 0 0 4 1 1 1 3 
3 0 0 5 5 5 0 0 1 1 0 0 0 0 0 0 0 0 0 5 0 0 0 0 3 
3 0 0 0 0 0 0 0 0 4 1 1 1 1 1 1 0 0 0 5 5 5 5 0 3 
3 0 7 0 0 0 0 0 0 0 0 0 0 0 0 0 0 0 0 0 0 0 4 0 3 
3 3 3 3 3 3 3 3 3 3 3 3 3 3 3 3 3 3 3 3 3 3 3 3 3
