25 19
32 64
4
2 288 128
2 64 352
1 32 512
1 736 512
4
320 192
96 384
32 544
736 544
3 3 3 3 3 3 3 3 3 3 3 3 3 3 3 3 3 3 3 3 3 3 3 3 3 
3 3 3 3 3 3 3 3 3 3 3 3 3 3 3 3 3 3 3 6 3 3 3 3 3 
3 1 1 1 1 1 1 1 1 1 1 1 1 1 4 1 1 1 1 0 0 5 0 0 3 
3 5 5 5 0 0 1 0 0 0 0 1 1 1 5 5 5 1 1 0 5 5 5 0 3 
3 5 5 5 5 0 4 0 0 0 0 0 0 0 5 6 6 5 0 0 0 6 1 0 3 
3 0 1 1 0 6 6 6 7 0 0 0 0 0 5 5 5 5 0 0 0 4 1 0 3 
3 0 1 1 0 0 6 6 7 0 0 1 1 1 1 1 1 1 0 0 0 1 1 0 3 
3 0 1 1 1 0 0 0 7 5 5 1 1 1 1 6 6 1 1 0 0 1 1 0 3 
3 0 1 1 1 0 0 0 7 5 5 1 1 1 1 6 6 1 1 0 0 1 1 0 3 
3 1 1 1 1 4 5 5 5 5 5 5 5 5 5 6 6 1 1 0 0 1 1 0 3 
3 0 0 0 5 1 1 1 1 1 1 1 6 1 1 4 6 1 1 0 6 6 1 0 3 
3 0 0 0 5 1 1 1 6 6 6 1 1 0 1 1 1 1 1 1 6 6 1 0 3 
3 0 0 0 5 5 1 1 1 1 6 1 1 0 0 1 0 0 0 0 0 0 1 0 3 
3 0 0 0 5 5 5 1 1 1 0 0 5 5 5 5 0 0 0 0 0 0 1 0 3 
3 1 1 1 1 0 0 1 1 1 0 5 1 1 4 5 5 5 1 1 1 1 1 0 3 
3 1 1 1 4 0 0 1 1 1 0 1 1 1 1 1 1 1 1 1 1 1 1 0 3 
3 1 1 6 6 0 0 0 0 0 0 1 1 1 1 1 1 1 6 6 6 1 1 0 3 
3 1 1 1 1 1 1 1 1 1 1 1 1 1 1 5 5 5 5 5 5 5 5 0 3 
3 3 3 3 3 3 3 3 3 3 3 3 3 3 3 3 3 3 3 3 3 3 3 3 3
