36 35
32 64
928 864
13
1 224 160
2 608 352
2 32 512
1 736 480
3 928 192
1 960 352
2 896 480
1 800 704
1 800 672
1 800 640
3 992 1024
3 160 928
2 64 664
6
256 160
672 352
32 544
736 544
32 632
160 800
3 3 3 3 3 3 3 3 3 3 3 3 3 3 3 3 3 3 3 3 3 3 3 3 3 3 3 3 3 3 3 3 3 3 3 3
3 3 3 3 3 3 3 3 3 3 3 3 3 3 3 3 3 3 3 3 3 3 3 3 3 3 3 3 3 3 3 3 3 3 3 3
3 9 0 0 0 0 1 1 1 1 1 5 5 5 5 0 0 0 0 0 0 5 5 7 7 1 5 4 4 4 4 4 4 3 3 3
3 0 0 0 0 0 1 4 0 0 1 0 0 0 5 0 0 0 5 5 5 5 5 7 7 1 5 5 4 4 4 4 4 3 3 3
3 0 1 1 1 1 1 0 0 0 1 1 1 1 1 1 1 4 5 5 0 5 5 7 7 1 1 1 1 1 1 4 4 3 3 3
3 0 5 5 0 0 0 0 0 0 1 0 0 5 5 0 1 1 1 1 0 0 0 2 2 1 1 1 1 1 1 1 1 3 3 3
3 0 5 5 5 1 1 1 1 1 1 0 0 5 5 0 0 0 0 1 4 0 0 2 2 1 1 1 1 1 1 1 1 3 3 3
3 0 5 0 0 1 0 0 0 5 5 5 5 5 5 0 4 1 1 1 0 0 0 7 7 1 1 1 1 1 1 1 1 3 3 3
3 1 1 1 1 1 0 0 0 0 0 5 5 5 0 0 1 1 0 0 0 5 5 7 7 7 7 7 1 1 1 1 1 3 3 3
3 1 1 1 1 1 1 1 1 1 1 1 1 1 0 0 1 0 0 0 0 5 5 7 7 7 7 7 7 7 7 1 1 3 3 3
3 0 0 0 1 0 4 0 0 0 0 0 4 1 1 1 1 0 0 0 5 5 4 7 7 7 7 7 7 7 7 1 1 3 3 3
3 0 5 5 1 0 0 0 5 5 5 0 0 0 0 0 1 0 0 0 0 0 4 0 7 7 7 1 1 2 2 1 1 3 3 3
3 0 5 5 1 0 0 5 5 5 5 5 5 5 0 0 1 0 0 0 4 4 4 0 0 7 7 1 1 7 7 7 7 3 3 3
3 0 5 5 1 0 0 0 0 5 5 5 5 5 5 0 1 1 1 1 1 1 1 1 0 7 7 1 1 7 7 7 7 3 3 3
3 0 5 5 1 1 1 1 1 4 0 0 5 0 0 0 1 4 0 0 4 1 1 1 0 7 7 1 1 1 1 1 1 3 3 3
3 0 0 5 5 5 0 0 1 1 0 0 0 0 0 0 0 0 0 0 0 0 0 0 0 7 7 1 1 1 1 1 1 3 3 3
3 0 0 0 0 0 0 0 0 4 1 1 1 1 1 1 0 0 0 5 5 5 5 0 5 7 7 1 1 1 1 1 1 3 3 3
3 0 5 0 0 0 0 0 0 0 0 0 0 0 0 0 0 0 0 0 0 0 4 0 5 7 7 1 1 1 1 1 1 3 3 3 
3 5 5 5 5 5 5 5 5 5 5 5 5 5 5 5 5 5 5 5 5 5 5 5 5 5 5 5 1 1 1 1 1 3 3 3
3 5 5 5 5 5 5 5 5 5 5 5 5 5 5 5 5 5 5 5 5 5 5 5 5 5 5 5 1 1 1 1 1 3 3 3
3 1 1 7 7 7 1 0 0 0 0 0 0 0 0 0 0 0 0 0 0 6 6 6 6 6 6 6 1 1 1 1 1 3 3 3
3 1 1 7 7 7 1 0 0 0 0 0 0 0 0 1 1 1 1 1 1 6 6 6 6 6 6 6 1 1 1 1 1 3 3 3
3 1 1 1 1 1 1 1 1 1 1 1 1 1 1 0 0 1 0 0 0 6 6 6 6 6 6 6 1 1 1 1 1 3 3 3
3 0 0 0 0 0 0 0 0 0 0 0 0 0 0 0 0 1 0 0 0 5 5 5 5 5 5 1 1 1 1 1 1 3 3 3
3 5 5 5 5 5 5 5 5 5 5 5 5 5 5 0 0 1 0 0 0 5 5 5 5 5 5 5 5 5 5 5 5 3 3 3
3 5 5 0 0 0 7 7 0 0 0 0 0 0 0 0 0 1 0 0 0 0 0 5 5 5 5 5 5 5 5 5 5 3 3 3
3 5 5 0 0 0 7 7 0 0 0 1 1 1 1 1 1 1 1 1 0 0 0 5 5 5 5 5 3 3 3 5 5 3 3 3
3 5 5 0 4 0 7 7 0 0 1 0 0 0 0 0 0 0 0 0 1 0 0 5 5 5 5 5 3 9 1 1 5 3 3 3
3 5 5 0 0 0 2 2 0 0 1 0 0 0 0 5 0 0 5 0 1 0 0 5 5 5 5 5 3 3 3 1 5 3 3 3 
3 5 5 0 0 0 2 2 1 1 1 0 0 4 0 5 0 0 5 0 1 0 0 5 5 5 5 5 5 5 1 1 5 3 3 3
3 5 5 0 4 0 7 7 0 0 4 0 0 0 5 5 0 0 0 5 0 1 0 0 0 1 1 1 5 5 1 1 5 3 3 3 
3 5 5 0 0 0 7 7 0 0 0 0 0 5 5 0 0 0 0 0 5 1 1 1 1 1 1 1 1 1 1 1 1 3 3 3 
3 5 5 0 0 0 7 7 0 0 0 0 5 5 0 0 0 0 0 0 5 0 0 4 4 1 1 1 1 1 1 1 1 3 3 3
3 3 3 3 3 3 3 3 3 3 3 3 3 3 3 3 3 3 3 3 3 3 3 3 3 3 3 3 3 3 3 3 3 3 3 3 
3 3 3 3 3 3 3 3 3 3 3 3 3 3 3 3 3 3 3 3 3 3 3 3 3 3 3 3 3 3 3 3 3 3 3 3